27 21
********* ***********
*.........*.........*
*.***.***.*.***.***.*
*B***.***.*.***.***B*
*.***.***.*.***.***.*
*...................*
*.***.*.*****.*.***.*
*.***.*.*****.*.***.*
*.....*...*...*.....*
*****.***.*.***.*****
    *.*.......*.*    
    *.*.** **.*.*    
*****.*.*F  *.*.*****
........*   *........
*****.*.*****.*.*****
    *.*.......*.*    
    *.*.     .*.*    
*****.*.     .*.*****
*.........  ........*
*.***.***. .***.***.*
*B..*.....P.....*..B*
***.*.*.*****.*.*.***
***.*.*.*****.*.*.***
*.....*...*...*.....*
*.*******.*.*******.*
*...................*
********* ***********
